{
    "groundTextureUrl": "../../assets/textures/ground.jpg",
    "wallTextureUrl": "../../assets/textures/wall.jpg",
    "size": { "width": 10, "height":10 },
    "map": [
        [3, 3, 2, 2, 2, 2, 1, 2, 2, 3, 1],
        [1, 1, 3, 2, 1, 1, 2, 2, 1, 1, 1],
        [1, 1, 2, 1, 1, 2, 2, 1, 1, 0, 1],
        [1, 2, 3, 1, 2, 2, 1, 1, 2, 0, 1],
        [3, 0, 0, 3, 1, 2, 0, 3, 1, 2, 1],
        [1, 3, 0, 0, 0, 3, 1, 0, 1, 1, 1],
        [1, 2, 1, 3, 2, 0, 2, 2, 1, 1, 1],
        [3, 2, 0, 2, 1, 1, 3, 1, 2, 1, 1],
        [1, 3, 0, 1, 2, 2, 0, 1, 2, 0, 1],
        [1, 2, 2, 1, 1, 2, 3, 0, 0, 2, 1],
        [2, 2, 2, 2, 2, 2, 2, 2, 2, 2, 0]
    ],
    "initialPosition": [0,3],
    "initialDirection": 0.0,
    "exitLocation": [-0.5, 6]
}